0 0 0 0 0 0 0 0 0 0 0 0 0 0 0 0 0 0 0 0 0 0 0 0 0 0 0 0 0 0 0 0 0 0 0 0 11 12 12 12 13 0 0 0 0 0 0 0 0 0 0 0 0 0 0 0 0 0 0 0 0 0 0 0 0 0 0 0 0 0 0 0 0 0 0 0 0 0 0 0 0 0 0 0 0 21 6 35 35 13 0 0 0 0 0 0 0 0 0 0 0 0 0 0 0 0 0 1 2 3 0 0 0 0 0 0 0 0 0 0 0 0 0 0 0 1 2 2 
0 0 0 0 0 0 0 0 0 0 0 0 0 0 0 0 0 0 0 0 0 0 0 0 0 0 0 0 0 0 0 0 0 0 0 0 11 12 12 12 13 0 0 0 0 0 0 0 0 0 0 0 0 0 0 0 0 0 0 0 0 0 0 0 0 0 0 0 0 0 0 0 0 0 0 0 0 0 0 0 0 0 0 0 0 0 21 6 12 24 2 3 0 0 0 0 0 0 0 0 0 0 0 0 0 0 45 35 22 23 0 0 0 0 0 0 0 0 0 0 0 0 0 0 0 11 33 35 
0 0 0 0 0 0 0 0 0 0 0 0 0 0 0 0 0 0 0 0 0 0 0 0 0 0 0 0 0 0 0 0 0 0 0 0 11 12 12 12 13 0 0 0 0 0 0 0 0 0 0 0 0 0 0 0 0 0 0 0 0 0 0 0 0 0 0 0 0 0 0 0 0 0 0 0 0 0 0 0 0 0 0 0 0 0 0 11 12 35 12 13 0 0 0 0 0 0 0 0 0 0 0 0 0 46 37 45 0 0 0 0 0 0 0 0 0 0 0 0 0 0 0 0 0 11 18 35 
0 0 0 0 0 0 0 0 0 0 0 0 0 0 0 0 0 0 0 0 0 0 0 0 0 0 0 0 0 0 0 0 0 0 0 0 11 12 12 12 13 0 0 0 0 0 0 0 0 0 0 0 0 0 0 0 0 0 0 0 0 0 0 0 0 0 0 0 0 0 0 0 0 0 0 0 0 0 0 0 0 0 0 0 0 0 0 21 22 6 12 24 3 0 0 0 0 0 0 1 2 2 2 2 2 35 23 0 0 0 0 0 0 0 0 0 0 0 0 0 0 0 0 0 1 26 42 35 
0 0 0 0 0 0 0 0 0 0 0 0 0 0 0 0 0 0 0 0 0 0 0 0 0 0 0 0 0 0 0 0 0 0 0 0 11 12 12 12 13 0 0 0 0 0 0 0 0 0 0 0 0 0 0 0 0 0 0 0 0 0 0 0 0 0 0 0 0 0 0 0 0 0 0 0 0 0 0 0 0 0 0 0 0 0 0 0 0 21 22 6 13 0 0 0 0 0 0 21 22 22 22 22 22 23 0 0 0 0 0 0 0 0 0 0 0 0 0 0 0 0 0 1 26 12 12 12 
0 0 0 0 0 0 0 0 0 0 0 0 0 0 0 0 0 0 0 0 0 0 0 0 0 0 0 0 0 0 0 0 0 0 0 0 11 12 12 12 13 0 0 0 0 0 0 0 0 0 0 0 0 0 0 0 0 0 0 0 0 0 0 0 0 0 0 0 0 0 0 0 0 0 0 0 0 0 0 0 0 0 0 0 0 0 0 0 0 0 0 11 13 0 0 0 0 0 0 0 0 0 0 0 0 0 0 0 0 0 0 0 0 0 0 0 0 0 0 0 0 0 0 11 12 12 35 12 
0 0 0 0 0 0 0 0 0 0 0 0 0 0 0 0 0 0 0 0 0 0 0 0 0 0 0 0 0 0 0 0 0 0 0 0 11 12 12 45 13 0 0 0 0 0 0 0 0 0 0 0 0 0 0 0 0 0 0 0 0 0 0 0 0 0 0 0 0 0 0 0 0 0 0 0 0 0 0 0 0 0 0 0 0 0 0 0 0 0 0 21 23 31 0 0 0 0 0 0 0 0 0 0 0 0 0 0 0 0 0 0 0 0 0 0 0 0 0 0 0 0 0 11 12 12 45 12 
2 2 2 3 0 0 0 0 0 0 0 0 0 0 0 0 0 0 0 0 0 0 0 0 0 0 0 0 0 0 0 0 0 0 0 0 11 12 12 55 24 3 0 0 0 0 0 0 0 0 0 0 0 0 0 0 0 0 1 2 2 2 2 3 0 0 0 0 0 0 0 0 0 0 1 2 2 2 2 2 2 3 0 0 0 0 0 0 0 0 0 0 0 0 0 0 0 0 39 7 1 2 3 9 9 9 9 1 2 3 0 0 0 0 0 0 0 0 0 0 0 0 0 11 12 12 55 12 
12 12 12 13 0 0 0 0 0 0 0 0 0 0 0 0 0 0 0 0 0 0 0 0 0 0 0 0 0 0 0 0 0 0 0 0 21 22 6 12 42 24 2 2 2 2 3 31 0 0 0 0 0 0 0 0 0 0 21 22 22 22 6 13 0 0 0 0 0 0 0 0 0 0 21 22 22 22 22 22 22 23 8 59 0 0 0 0 0 0 0 0 0 0 0 0 0 0 0 0 11 12 13 0 0 0 0 11 12 13 0 0 0 0 0 0 0 0 0 0 0 0 0 11 35 12 12 12 
4 22 22 23 54 54 0 0 0 0 0 0 0 0 0 0 0 0 0 0 0 0 0 0 0 0 0 0 0 0 0 0 0 0 0 0 0 0 21 6 52 12 41 42 43 12 13 31 31 0 0 0 0 0 0 0 0 0 0 0 0 0 11 45 9 0 0 0 0 0 0 0 0 0 0 0 0 0 0 0 0 0 0 0 0 0 0 0 0 0 0 0 0 0 0 0 0 0 0 0 11 12 13 0 0 0 0 21 22 23 0 0 0 0 0 0 0 0 0 0 0 0 0 11 45 12 12 12 
13 0 0 0 0 39 59 0 0 0 0 0 0 0 0 0 1 2 2 2 3 0 0 0 0 0 0 0 0 0 0 0 0 0 0 0 0 0 0 11 12 51 52 52 12 12 13 31 31 31 0 0 0 0 0 0 0 0 0 0 0 0 11 55 0 0 0 0 0 0 0 0 0 0 0 0 0 0 0 0 0 0 0 0 0 0 0 0 0 0 0 0 0 0 0 0 0 0 0 0 11 12 13 0 0 0 0 0 0 0 0 0 0 0 0 0 0 0 0 0 0 0 0 11 51 44 41 35 
13 0 0 0 0 0 0 0 0 0 0 0 0 0 0 0 21 22 22 22 23 0 0 0 0 0 0 0 0 0 0 0 0 0 0 0 0 0 0 21 22 22 22 22 22 22 23 0 0 0 0 0 0 0 0 0 0 0 0 0 0 0 0 0 0 0 0 0 0 0 0 0 0 0 0 0 0 0 0 0 0 0 0 0 1 3 0 0 0 0 0 0 0 0 0 0 0 31 31 31 21 22 23 0 0 0 0 0 0 0 0 0 0 47 2 2 2 2 2 2 2 2 2 26 12 12 12 45 
13 0 0 0 0 0 0 0 0 0 0 0 0 0 0 0 0 0 0 0 0 0 0 0 0 0 0 1 2 3 0 0 0 0 0 0 0 0 0 0 0 0 0 0 0 0 0 0 0 0 0 0 0 0 0 0 0 0 0 0 0 0 0 0 0 0 0 0 0 0 0 0 0 0 0 0 0 0 0 0 0 0 0 0 21 23 0 0 0 0 0 0 0 0 0 0 0 0 0 0 0 0 0 0 0 0 0 0 0 0 0 0 47 57 4 22 23 39 39 39 21 6 12 33 35 33 12 55 
13 0 0 0 0 0 0 0 0 0 0 0 0 0 0 0 0 0 0 0 0 0 0 0 0 0 0 11 12 13 0 0 0 0 0 0 0 0 0 0 0 0 0 0 0 0 0 0 0 0 0 0 0 0 0 0 0 0 0 0 31 31 1 2 7 7 7 7 7 59 0 0 0 0 0 0 0 0 0 0 0 0 0 0 0 0 0 0 0 0 0 0 0 0 0 0 0 0 0 0 0 0 0 0 0 0 0 0 0 0 0 47 57 4 23 0 0 0 0 0 0 21 6 18 35 33 35 12 
13 0 0 31 31 31 31 31 0 0 0 0 0 0 0 0 0 0 0 0 0 0 0 0 0 0 0 21 22 23 0 0 0 0 0 0 0 0 0 0 0 0 0 0 0 0 0 0 0 0 0 0 1 2 3 0 0 0 0 0 0 0 11 46 0 0 0 0 0 0 0 0 0 0 0 0 0 0 0 0 0 0 0 0 0 0 0 0 0 0 0 0 0 0 0 0 0 0 0 0 0 0 0 0 0 0 0 0 0 0 47 57 4 23 0 0 0 0 0 0 0 0 11 42 35 33 45 12 
13 0 0 0 0 0 0 31 31 31 1 2 2 2 2 2 2 3 0 0 0 0 0 0 0 0 0 0 0 0 0 0 0 0 0 0 0 0 0 0 0 0 0 0 0 0 0 0 0 0 0 0 11 12 13 0 0 0 0 0 0 0 11 46 0 0 0 0 0 0 0 0 0 0 0 0 0 0 0 0 0 0 0 0 0 0 0 0 0 0 0 0 0 0 0 0 0 0 0 0 0 0 0 0 0 0 0 0 0 47 57 4 23 0 0 0 0 0 0 0 0 0 11 12 12 45 55 12 
13 0 0 0 0 0 0 0 0 0 21 22 22 22 22 22 22 23 0 0 0 0 0 0 0 0 0 0 0 0 0 0 0 0 0 0 0 0 0 0 0 0 0 0 0 1 2 2 2 3 0 0 11 12 13 31 31 0 0 0 0 0 11 33 0 0 0 0 0 0 0 0 0 0 0 0 0 0 0 0 0 0 0 0 0 0 0 1 2 2 2 3 0 0 0 0 1 2 2 2 3 0 0 0 0 1 2 2 2 26 22 23 0 0 0 0 0 0 0 0 0 0 11 12 12 55 12 12 
13 31 0 0 0 0 0 0 0 0 0 0 0 0 0 0 0 0 0 0 0 0 0 0 0 0 0 0 0 0 0 0 0 0 0 0 0 0 0 0 0 0 0 0 0 21 22 22 22 23 0 0 11 12 13 0 0 0 0 0 0 0 11 46 0 0 0 0 0 0 0 0 0 0 0 0 0 0 0 0 0 0 0 0 0 0 0 21 22 22 22 23 0 0 0 0 21 22 22 22 23 0 0 0 0 21 22 22 22 23 0 0 0 0 0 0 0 0 0 0 0 1 26 12 12 12 12 12 
13 0 0 0 0 0 0 0 0 0 0 0 0 0 0 0 0 0 0 0 0 0 0 0 0 0 0 0 0 0 0 0 0 0 0 0 0 0 0 0 0 0 0 0 0 0 0 0 0 0 0 0 11 12 13 0 0 0 0 0 0 0 11 46 0 0 0 0 0 0 0 0 0 0 0 0 0 0 0 0 0 0 0 0 0 0 0 0 0 0 0 0 0 0 0 0 0 0 0 0 0 0 0 0 0 0 0 0 0 0 0 0 0 0 0 0 0 0 0 0 0 11 12 35 51 44 41 35 
13 0 0 0 0 0 0 0 0 0 0 0 0 0 0 0 0 0 0 0 0 0 0 0 0 0 0 0 0 0 0 0 0 0 1 2 2 2 2 2 2 3 0 0 0 0 0 0 0 0 0 0 11 12 13 0 0 0 0 0 31 31 11 46 0 0 0 0 0 0 0 0 0 0 0 0 0 0 0 0 0 0 0 0 0 0 0 0 0 0 0 0 0 0 0 0 0 0 0 0 0 0 0 0 0 0 0 0 0 0 0 0 0 0 0 0 0 0 0 0 0 11 12 45 12 12 12 45 
13 0 0 0 0 0 0 0 0 0 0 0 0 0 0 0 0 1 2 2 2 3 0 0 0 0 0 0 0 0 0 0 0 0 21 22 22 22 22 22 22 23 0 0 0 0 0 0 0 0 0 0 11 12 13 0 0 0 0 0 0 0 11 33 0 0 0 0 0 0 0 1 2 2 2 3 1 2 2 1 2 2 2 3 0 0 0 0 0 0 0 0 0 0 0 0 0 0 0 0 0 0 0 0 0 0 0 0 0 0 0 0 0 0 0 0 0 0 0 0 1 26 12 55 12 12 12 55 
1 2 3 0 0 0 0 0 0 0 0 0 0 1 2 2 35 26 12 12 12 24 25 25 25 48 0 0 0 0 0 0 0 0 0 0 0 0 0 0 0 0 0 0 0 0 0 0 0 0 0 0 21 22 23 33 33 0 0 0 0 0 11 46 0 0 0 0 0 0 0 11 12 42 35 33 45 12 12 12 12 12 12 13 0 0 0 0 0 0 0 0 0 0 0 0 0 0 0 0 0 0 0 0 0 0 0 0 0 0 0 0 0 0 0 0 0 0 0 0 11 12 12 12 12 35 12 12 
11 12 13 0 0 0 0 0 0 0 0 0 1 26 12 12 45 12 12 12 12 12 31 12 12 58 48 0 0 0 0 0 0 0 0 0 0 0 0 0 0 0 0 0 0 0 0 0 0 0 0 0 0 0 0 0 0 0 0 0 0 0 0 0 0 0 0 0 0 0 8 11 12 12 12 45 55 12 12 12 12 12 12 13 0 0 0 0 0 0 0 0 0 0 0 0 0 0 0 0 0 0 0 0 0 0 0 0 0 0 0 0 0 0 0 0 0 0 0 0 11 12 33 33 35 12 12 12 
4 5 24 2 2 2 2 2 2 2 2 2 26 12 12 12 55 12 12 12 12 12 45 12 12 12 58 48 0 0 0 0 0 0 0 0 0 0 0 0 0 0 0 0 0 0 0 0 0 0 0 0 0 0 0 0 0 0 0 0 0 0 0 0 0 0 0 0 0 0 0 11 12 12 42 35 33 45 12 42 35 33 45 24 3 0 0 0 0 0 0 0 0 0 1 2 2 2 3 0 0 0 0 0 0 0 0 0 0 0 0 0 0 0 0 0 0 0 0 0 11 12 18 18 35 33 33 33 
14 15 32 33 33 33 35 12 12 12 12 12 12 51 44 41 35 12 12 12 12 12 55 12 12 12 12 58 2 2 2 2 2 3 0 0 0 0 0 0 0 0 0 0 0 0 0 0 0 0 0 0 0 0 0 0 0 0 1 3 0 0 0 0 0 0 1 2 2 2 2 26 12 12 12 12 45 55 12 12 12 45 55 12 24 2 2 2 2 2 2 2 2 2 26 12 12 12 24 2 2 2 2 2 2 2 2 2 2 2 2 2 2 2 2 2 2 2 2 2 33 33 42 42 35 12 12 12 
24 25 26 18 18 18 35 33 33 33 35 34 12 12 12 12 45 12 12 12 12 33 33 35 12 12 12 12 12 12 12 12 12 24 2 2 2 2 2 2 2 2 2 2 2 2 2 2 2 59 0 0 0 0 0 0 0 0 21 23 42 2 26 46 33 33 33 33 35 34 12 12 12 35 12 12 55 12 18 12 12 55 12 33 33 35 12 12 12 12 12 12 12 12 33 33 35 12 12 12 12 12 12 51 44 41 12 12 12 12 12 33 33 35 33 35 12 12 12 12 12 51 44 41 35 12 12 12 
41 42 42 42 42 42 35 12 12 12 45 12 12 12 12 12 55 12 12 12 12 18 18 35 33 33 33 33 33 35 12 12 12 12 12 12 12 12 12 12 12 12 31 31 0 0 0 0 0 0 0 0 0 0 0 0 0 0 42 42 35 42 42 46 12 12 12 12 45 12 12 12 12 12 12 12 12 12 42 12 12 12 12 18 18 35 33 33 33 35 12 12 12 12 18 18 35 33 33 33 35 34 12 12 12 12 12 12 12 12 12 18 18 35 33 35 33 33 35 34 12 12 12 12 45 12 12 12 
12 12 12 12 12 12 35 12 12 12 55 12 12 33 33 33 35 33 33 33 33 42 42 35 12 12 12 18 18 35 33 33 33 12 12 12 12 12 12 32 33 32 33 31 0 0 0 0 0 0 0 0 0 0 0 0 0 0 12 12 12 35 12 46 12 12 12 12 55 12 12 33 33 33 35 51 44 41 12 35 51 44 41 42 42 35 12 12 12 45 33 33 33 33 42 42 35 12 12 12 45 12 12 12 12 12 33 33 33 33 33 42 42 35 33 33 35 12 45 12 12 12 12 12 55 12 12 12