0 0 0 0 0 0 0 0 0 0 0 0 0 0 0 0 0 0 0 0 0 0 0 0 0 0 0 0 0 0 0 0 0 0 0 0 0 0 0 0 703 704 705 706 707 708 709 710 711 0 0 0 0 0 0 0 0 1146 1147 1148 1149 0 0 0 0 0 0 0 0 0 0 0 0 0 0 0 0 0 0 0 0 0 0 0 0 0 0 0 0 0 0 0 0 0 0 0 0 0 0 0 0 0 0 0 0 0 0 0 0 0 0 0 0 0 0 0 0 0 0 0 0 0 0 0 0 0 0 0 
0 0 0 0 0 0 0 0 0 0 0 0 0 0 0 0 0 0 0 0 0 0 0 0 0 0 0 0 0 0 0 0 0 0 0 0 0 0 0 0 743 744 745 746 747 748 749 750 751 0 0 0 0 0 0 0 0 1186 1187 1188 1189 0 0 0 0 0 0 0 0 0 0 0 0 0 0 0 0 0 0 0 0 0 0 0 0 0 0 0 0 0 0 0 0 0 0 0 0 0 0 0 0 0 0 0 0 0 0 0 0 0 0 0 994 995 996 997 998 999 0 0 0 0 0 0 0 0 0 0 
0 0 0 0 0 0 0 0 0 0 0 0 0 0 0 0 0 0 0 0 0 0 0 0 0 0 0 0 0 0 0 0 0 0 0 0 0 0 0 0 783 784 785 786 787 788 789 790 791 0 0 0 0 0 0 0 0 1226 1227 1228 1229 0 0 0 0 0 0 0 0 0 0 0 0 0 0 0 0 800 801 802 803 0 0 0 0 0 0 0 0 0 0 0 0 0 0 0 0 0 0 0 0 0 0 0 0 0 0 0 0 0 0 0 1034 1035 1036 1037 1038 1039 0 0 0 0 0 0 0 0 0 0 
0 0 0 0 0 0 0 0 0 0 0 0 0 0 0 0 0 0 0 0 0 0 0 0 0 0 0 0 0 0 0 0 0 0 0 0 0 0 0 0 823 824 825 826 827 828 829 830 831 0 0 0 0 0 0 0 0 1266 1267 1268 1269 0 0 0 0 0 0 0 0 0 0 0 0 0 0 0 0 840 841 842 843 0 0 0 0 0 0 0 0 0 0 0 0 0 0 0 0 0 0 0 0 0 0 0 0 0 0 0 0 0 0 0 1074 1075 1076 1077 1078 1079 0 0 0 0 0 0 0 0 0 0 
0 0 0 0 0 0 0 0 0 0 0 0 0 0 0 0 0 0 0 0 0 0 0 0 0 0 0 0 0 0 0 0 0 0 0 0 0 0 0 0 0 864 865 866 867 868 869 870 0 0 0 0 0 0 0 0 0 1306 1307 1308 1309 0 0 0 0 0 0 0 0 0 0 0 0 0 0 0 0 880 881 882 883 0 0 0 0 0 0 0 0 0 0 0 0 0 0 0 0 0 0 0 0 0 0 0 0 0 0 0 0 0 0 0 1114 1115 1116 1117 1118 1119 0 0 0 0 0 0 0 0 0 0 
0 0 0 0 0 0 0 217 218 0 0 0 0 0 0 0 0 0 0 0 0 0 0 0 0 0 0 0 0 0 0 0 0 0 0 0 0 0 0 0 0 904 905 906 907 908 909 910 0 0 0 0 0 0 0 0 0 1346 1347 1348 1349 524 525 0 0 0 0 0 0 0 0 0 0 0 0 0 0 920 921 922 923 0 0 0 0 0 0 0 0 0 0 0 0 0 0 0 0 0 0 0 0 0 0 0 0 0 0 0 0 0 0 0 1154 1155 1156 1157 1158 1159 0 0 0 0 0 0 0 0 0 0 
980 981 0 0 0 0 0 257 258 0 0 0 0 0 0 0 0 0 0 0 0 0 0 0 0 0 0 0 0 0 0 0 0 0 0 0 0 0 0 0 0 0 0 946 947 948 0 0 0 0 0 0 0 0 0 0 0 1386 1387 1388 1389 564 565 0 0 0 0 0 0 0 0 0 0 0 0 0 0 960 961 962 963 0 0 0 0 0 0 0 0 0 0 0 0 0 0 0 0 0 0 0 0 0 0 0 0 0 0 0 0 0 0 0 1194 1195 1196 1197 1198 1199 0 0 0 0 0 0 0 0 0 0 
0 0 0 0 0 0 0 297 298 0 0 0 0 0 0 0 0 0 0 0 0 0 0 0 0 0 0 0 0 0 0 0 0 0 0 0 0 0 0 0 0 0 0 986 987 988 0 0 0 0 0 0 0 0 0 0 0 0 0 0 0 0 0 0 0 0 0 0 0 0 0 0 0 0 0 0 0 0 0 0 0 0 0 0 0 0 0 0 0 0 0 0 0 0 0 0 0 0 0 0 0 0 0 0 0 0 0 0 0 0 0 0 1234 1235 1236 1237 1238 1239 452 453 454 455 456 0 0 0 0 0 
0 0 0 0 0 0 0 337 338 339 0 0 0 0 0 0 0 0 0 0 0 0 0 0 0 0 0 0 0 0 0 0 0 0 0 0 0 0 0 0 0 0 0 0 0 0 0 0 0 0 0 0 0 0 0 0 0 0 0 0 0 0 0 0 0 0 0 0 0 0 0 0 0 0 0 0 0 0 0 0 0 0 0 0 0 0 0 0 0 0 0 0 0 0 0 0 0 0 0 0 0 0 0 0 0 0 0 0 0 0 0 0 1274 1275 1276 1277 1278 1279 492 493 494 495 496 0 0 0 0 0 
0 0 0 0 0 0 0 377 378 379 0 0 0 0 0 0 0 0 0 0 0 0 0 0 0 0 0 0 0 0 0 0 0 0 0 0 0 0 0 0 0 0 0 0 0 0 0 0 0 0 0 0 0 0 0 0 0 0 0 0 0 0 0 0 0 0 0 0 0 0 0 0 0 0 0 0 0 0 0 0 0 0 0 0 0 0 0 0 0 0 0 0 0 0 0 0 0 0 0 0 0 0 0 0 0 0 0 0 0 0 0 0 1314 1315 1316 1317 1318 1319 532 533 534 535 536 0 0 0 0 0 
0 0 0 0 0 0 0 417 418 419 0 0 0 0 0 0 0 0 0 0 0 0 0 0 0 0 0 0 1337 1338 0 0 0 0 0 0 0 0 0 0 0 0 0 0 0 0 0 0 0 0 0 0 0 0 0 0 0 0 0 0 0 0 0 0 0 0 0 0 0 0 0 0 0 623 624 625 626 627 628 629 630 631 0 0 0 0 0 0 0 0 0 0 0 0 0 0 0 0 0 0 0 0 0 0 0 0 0 0 0 0 0 0 0 0 0 1357 1358 571 572 573 574 575 576 0 0 0 0 0 
0 0 0 0 0 0 0 457 458 0 451 452 453 454 455 456 0 0 0 0 0 0 0 0 0 0 0 0 1377 1378 0 0 0 0 0 0 1092 1093 1094 0 0 0 0 0 0 0 0 0 0 0 0 0 0 0 0 0 0 0 0 0 0 0 0 0 0 0 0 0 0 0 0 0 0 663 664 665 666 667 668 669 670 671 0 0 0 0 0 0 0 0 0 0 0 0 0 0 0 0 0 0 0 0 0 0 0 0 0 0 0 0 0 0 0 0 0 0 0 0 0 0 0 0 0 0 0 0 0 0 
0 0 0 0 0 0 0 497 498 0 491 492 493 494 495 496 0 0 0 0 0 0 0 0 0 0 0 0 0 0 0 0 0 0 0 0 1132 1133 1134 0 0 0 0 0 0 0 0 0 0 0 0 0 0 0 0 0 0 0 0 0 0 0 0 0 0 0 0 0 0 0 0 0 0 703 704 705 706 707 708 709 710 711 0 0 0 0 0 0 0 0 0 0 0 0 0 0 0 0 0 0 0 0 0 0 0 0 0 0 0 0 0 0 0 0 0 0 0 0 0 0 0 0 0 0 0 0 0 0 
0 0 0 0 0 0 0 537 538 0 531 532 533 534 535 536 0 0 0 0 0 1091 1092 1093 1094 0 0 0 0 0 0 0 0 0 0 0 1172 1173 1174 0 0 0 0 0 0 0 0 0 0 0 0 0 0 0 0 0 0 0 0 0 0 0 0 0 0 0 0 0 0 0 0 0 0 743 744 745 746 747 748 749 750 751 0 0 0 0 0 0 0 0 0 0 0 0 0 0 0 0 0 0 0 0 0 0 0 0 0 0 0 0 0 0 0 0 0 0 0 0 0 0 0 0 0 0 0 0 0 0 
0 0 0 0 0 0 0 577 578 0 571 572 573 574 575 576 0 0 0 0 0 1131 1132 1133 1134 0 0 0 0 0 0 0 0 0 0 0 1212 1213 1214 0 0 0 0 0 0 0 0 0 0 0 0 0 0 0 0 0 0 0 0 0 0 0 0 0 0 0 0 0 0 0 0 0 0 783 784 785 786 787 788 789 790 791 0 0 0 0 0 0 949 950 951 0 0 0 0 0 0 0 0 0 0 0 0 0 0 0 0 0 0 0 0 204 205 206 207 208 209 210 211 212 0 0 0 0 0 0 0 0 
0 0 0 0 0 0 0 0 0 0 0 0 0 0 0 0 0 0 0 0 0 1171 1172 1173 1174 0 0 0 0 0 0 0 0 0 0 0 1252 1253 1254 0 0 0 0 0 0 0 0 0 0 0 0 0 0 0 0 0 0 0 0 0 0 0 0 0 0 0 0 0 0 0 0 0 0 823 824 825 826 827 828 829 830 831 0 0 0 0 0 0 989 990 991 0 0 0 0 0 0 0 985 0 0 0 0 0 0 0 981 0 0 0 0 244 245 246 247 248 249 250 251 252 0 0 0 0 0 0 0 0 
0 0 0 0 0 0 0 0 0 0 0 0 0 0 0 0 0 0 0 0 0 1211 1212 1213 1214 0 0 0 307 308 309 310 311 0 0 0 1292 1293 1294 0 0 0 0 0 0 0 0 0 0 0 0 0 0 0 0 0 0 0 0 0 0 0 0 0 0 0 0 0 0 0 0 0 0 863 864 865 866 867 868 869 870 871 0 0 0 0 0 0 0 0 0 0 0 0 0 0 0 0 0 0 0 0 0 0 0 0 0 0 0 0 0 284 285 286 287 288 289 290 291 292 0 0 0 0 0 0 0 0 
0 0 0 0 0 0 0 0 0 0 0 0 0 0 0 0 0 0 0 0 0 1251 1252 1253 1254 0 0 0 347 348 349 350 351 0 0 0 1332 1333 1334 949 950 951 0 0 0 0 0 0 303 0 0 0 0 0 0 0 0 0 0 0 0 0 0 0 0 0 0 0 0 0 0 0 0 903 904 905 906 907 908 909 910 911 0 0 0 0 0 0 0 0 0 0 0 0 0 0 0 0 0 0 0 0 0 0 0 0 0 0 0 0 0 324 325 326 327 328 329 330 331 332 0 0 0 0 0 0 0 0 
0 0 0 0 0 1200 1201 1202 1203 1204 0 0 0 0 0 0 0 0 0 0 0 1291 1292 1293 1294 0 0 0 387 388 389 390 391 0 0 557 1372 1373 1374 989 990 991 0 0 0 0 0 0 343 0 0 0 0 0 0 0 0 0 0 0 0 0 0 0 0 0 0 0 0 0 0 0 0 943 944 945 946 947 948 949 950 951 0 0 0 0 0 0 0 0 0 0 0 0 0 0 0 0 0 0 0 0 0 0 0 0 0 0 0 0 0 364 365 366 367 368 369 370 371 372 0 0 0 0 0 0 0 0 
0 0 0 0 0 1240 1241 1242 1243 1244 0 0 0 0 0 0 0 0 0 0 1368 1331 1332 1333 1334 0 0 0 427 428 429 430 431 0 0 0 0 0 0 0 0 0 0 0 0 0 0 382 383 0 0 0 0 0 0 0 0 0 0 0 0 0 0 0 0 0 0 0 0 0 0 0 982 983 984 985 986 987 988 989 990 991 0 0 0 0 0 0 0 0 0 0 0 0 0 0 0 0 0 0 0 0 0 0 0 0 0 0 0 0 0 404 405 406 407 408 409 410 411 412 0 0 0 0 0 0 0 0 
0 0 0 0 0 1280 1281 0 1283 1284 1285 0 0 557 0 0 0 0 0 0 0 1371 1372 1373 1374 0 0 0 467 468 469 470 471 0 0 0 0 0 0 0 0 0 0 0 0 0 0 422 423 424 0 0 0 0 0 0 0 0 0 0 0 0 0 0 0 0 0 0 0 0 0 0 0 0 0 0 0 0 0 0 0 0 0 0 0 0 0 0 0 0 0 0 0 0 0 0 0 0 0 0 0 0 0 0 0 0 0 0 0 0 0 444 445 446 447 448 449 450 451 452 0 0 0 0 0 0 0 0 
0 0 0 0 0 1320 1321 0 1323 1324 1325 0 0 0 0 0 0 0 0 0 0 0 0 0 0 0 0 0 507 508 509 510 511 0 0 0 0 0 0 0 0 0 0 0 0 0 0 462 463 0 0 0 0 0 0 0 0 0 0 0 0 0 0 0 0 0 0 0 0 0 0 0 0 0 0 0 0 0 0 0 0 0 0 0 0 0 0 0 0 0 0 0 0 0 0 0 0 0 0 0 0 0 0 0 0 0 0 0 0 0 0 484 485 486 487 488 489 490 491 492 0 0 0 0 0 0 0 0 
0 0 0 0 1359 1360 1361 0 1363 1364 1365 0 0 0 0 0 0 0 0 0 0 0 0 0 0 0 0 0 547 548 549 550 551 0 0 0 0 0 0 0 0 0 0 0 0 0 0 0 503 0 0 0 0 0 0 0 0 0 0 0 0 0 0 0 0 0 0 0 0 0 0 0 0 0 0 0 0 0 0 0 0 0 0 0 0 0 0 0 0 0 0 0 0 0 0 0 985 0 0 0 0 0 940 941 942 943 944 945 0 0 0 0 0 0 527 528 0 0 0 0 0 0 0 0 0 0 0 0 
0 0 0 0 0 0 0 0 0 0 0 0 0 0 0 0 0 0 0 0 0 0 0 0 0 0 0 0 587 588 589 590 591 0 0 0 0 0 0 0 0 0 0 0 0 0 0 0 543 0 0 0 0 0 0 0 0 0 0 0 0 0 0 0 0 0 0 0 0 0 0 0 0 0 0 0 0 0 0 0 0 0 0 0 0 0 579 580 581 582 0 0 0 0 0 0 0 0 0 0 985 0 980 981 982 983 984 985 0 0 0 980 981 0 567 568 569 0 980 981 0 0 0 0 0 0 0 0 
0 0 0 0 0 0 0 0 0 0 0 0 0 0 0 0 0 0 0 0 0 0 0 0 0 0 0 0 0 0 0 0 0 0 0 0 0 559 0 0 0 0 581 582 0 0 0 0 583 0 0 0 0 0 0 0 0 0 0 0 0 559 0 0 0 0 0 0 0 0 0 0 0 0 0 0 0 0 0 0 0 0 0 0 0 0 0 0 0 0 0 0 0 0 0 0 0 0 0 0 0 0 0 0 0 0 0 0 0 0 0 0 0 0 0 0 0 0 0 0 0 0 0 0 0 0 0 0 
0 0 0 0 0 0 0 0 0 0 0 0 0 0 0 0 0 0 0 0 0 0 0 0 0 0 0 0 0 0 0 0 0 0 0 0 0 0 0 0 0 0 0 0 0 0 0 0 0 0 0 0 0 0 0 0 0 0 0 0 0 0 0 0 0 0 0 0 0 0 0 0 0 0 0 0 0 0 0 0 0 0 0 0 0 0 0 0 0 0 0 0 0 0 0 0 0 0 0 0 0 0 0 0 0 0 0 0 0 0 0 0 0 0 0 0 0 0 0 0 0 0 0 0 0 0 0 0 
0 0 0 0 0 0 0 0 0 0 0 0 0 0 0 0 0 0 0 0 0 0 0 0 0 0 0 0 0 0 0 0 0 0 0 0 0 0 0 0 0 0 0 0 0 0 0 0 0 0 0 0 0 0 0 0 0 0 0 0 0 0 0 0 0 0 0 0 0 0 0 0 0 0 0 0 0 0 0 0 0 0 0 0 0 0 0 0 0 0 0 0 0 0 0 0 0 0 0 0 0 0 0 0 0 0 0 0 0 0 0 0 0 0 0 0 0 0 0 0 0 0 0 0 0 0 0 0 
0 0 0 0 0 0 0 0 0 0 0 0 0 0 0 0 0 0 0 0 0 0 0 0 0 0 0 0 0 0 0 0 0 0 0 0 0 0 0 0 0 0 0 0 0 0 0 0 0 0 0 0 0 0 0 0 0 0 0 0 0 0 0 0 0 0 0 0 0 0 0 0 0 0 0 0 0 0 0 0 0 0 0 0 0 0 0 0 0 0 0 0 0 0 0 0 0 0 0 0 0 0 0 0 0 0 0 0 0 0 0 0 0 0 0 0 0 0 0 0 0 0 0 0 0 0 0 0